000000000000
111111111111
101111110031
131211111111
101111111111
101111111111
111105011111
111111110111
104001110211
111111110111
112111113111
111111110111
111111111111