000000000000
111111111111
112111111111
111111120401
111111111111
103011111111
111105011111
101111111121
131110401111
101211111111
111111110401
111111111111
111111111111