000000000000
111111111111
112111010401
111111311111
103011011111
111111111211
111050501111
111111111111
111201111111
111131111121
111101104011
111111111111
111111111111