111111111111
113301012111
111111311111
121111011211
111111111111
111105011011
112111111411
111111111011
110401111121
111111030111
111111111111
111111111111